NO ./frames/images
SO ./frames/images
WE ./frames/images
EA ./frames/images

F 2,10,24
C 205,30,250



1111111111111111111111111111111111111111111111
1111110000000111111111111111111
1111111000000111000000000000111
1000000000000000000000000000001
100000000000000000011111111111
1000000000000000000111111111111
1100000000000001000000000000111
100000000W000010010000000000111
110000000000000100000000000011111111111
1001000000111011110000000000111
1111111111111111111111111111111