NO ./frames/walls/asd.png
SO ./frames/walls/mages.png
WE ./frames/walls/text.png
EA ./frames/walls/DT.png
F 2,10,24
C 205,30,250



1111111111111111111111111111111111111111111
11111000000011111111111111111001
11111110000001110000000000001101
10000000000000000000000000000001
1000000000000000000111111111111
10000000E0010001000111111111111
1100000000000001000000000000111
1000000000000010010000000000111
110000000000000100000000000011111111111
1001000000111011110000000000111
1111111111111111111111111111111
1111111111111111111111111111111
1111111111111111111111111111111