NO ./frames/images
SO ./frames/images
WE ./frames/images
EA ./frames/images

F 2,10,24
C 205,30,250



11111111111111111111
11111100000000000000111
11111100000000000001111
1111110W0000000000000001
111111000000000000001111
1111110000000000000011111  
11111110000000000001111111
110000000000000000001101
 110000000000000000001101
110000000000000000000001
  100100000000000000001
   11 11111111111111111   1