NO ./path_to_the_north_texture
       SO     ./path_to_the_south_texture
    WE ./path_to_the_west_texture
           EA ./path_to_the_east_texture

F 2,10,24
C 205,30,250



  11111111111111111111
  111111000000011111111
  1111110000000111111111
  11111100000001111111111
  11111100000001111111111111111111
  11111100000001111111111        11111
  11111110000001110011111111111111 11
  11000000000000010011101
 1100000000W000010011101
11000000000000010011101
  10010000001110111111
   11 111111   1