NO ./frames/images
SO ./frames/images
WE ./frames/images
EA ./frames/images

F 2,10,24
C 205,30,250



11111111111
1111110000111
1111110001111
1111110W000001
11111100001111
111111000011111  
1111111001111111
11000000001101
 11000000001101
11000000000001
  10010000001
   11 111111   1