NO ./path_to_the_north_texture
SO ./path_to_the_south_texture
WE ./path_to_the_west_texture
EA ./path_to_the_east_texture

F 220,100,0
C 225,30,0




        1111111111111111111111111
        1000000000110000000000001
        101100000111000000000001
        100100000000000000000001
1111111110110S0001110000000000001
10000000001100000111011111111111
11110111111111011100000010001
111101111111110111010100100001
11000000110101011100000010001
1000000000000000110000001000111
1000000000000000110101001010001
110000011101010111110111100111
11110111 1110101 101111010101
11111111 1111111 111111111111