NO ./frames/images
SO ./frames/images
WE ./frames/images
EA ./frames/images

F 2,10,24
C 205,30,250



  11111111111111111111
  1111110000000110001111
  11111100000000000011111
  11111100000000000000001
  11111100000000000001111
  111111000000000000111111  
  1111111001000111001111111
  11000000000000010011101
 1100000000W000000011101
11000000000000000011101
  10010000001110111111
   11 111111   1