NO ./walls/asd.png
SO ./walls/DT.png
EA ./walls/mages.png
WE ./walls/MEHE.png

F 175,125,60
C 173,216,230

    111111111111111111111111111111111
    1111100000001111111111111111101
    11111110000001110000000000001101
111110000000000000000000000000000001
100000S0000000000001111111111111111
1000000000000010010000000000111
1111111111111111111111111111111

1111111111111111111111111111111
1100000000000001000000000000111
1001000000111011110010000010011
1001000000111011110001111100011
1001000000111011110000000000111
1111111111111111111111111111111